#################################################
#                   #    #           #          #
#         #         #    #           ###        #
#         #         #    #             #        #
<         #                            #        >
#         #                                     #
#                                               #
#                   #                           #
#################################################

